###############################################################################
#                                                                             #
#  $$$$$$$$$$$$$$$$$$$$$$$$$$$$$$$$$$$$$$$$$$$$$$$$$$$$$$$$$$$$$$$$$$$$$$$$$$ #
#  $                                                                        $ #
#  $                                                                        $ #
#  $     **************************************************************     $ #
#  $    *------------------------*-----------------*-------------------*    $ #
#  $    *------------*-------------------------------------------------*    $ #
#  $    *--------**********************************************--------*    $ #
#  $    *--------*                                            *--------*    $ #
#  $    *--------*              *****************             *--------*    $ #
#  $    *--------*             *-----------------*            *--------*    $ #
#  $    *--------***************---***-----***---**************--------*    $ #
#  $    *-------------------------*   *---*   *------------------------*    $ #
#  $    *--------------------------***-----***-------------------------*    $ #
#  $    *--------------------------------------------------------------*    $ #
#  $    *--------------------------------------------------------------*    $ #
#  $    *--------------------------***-----***-------------------------*    $ #
#  $    *-------------------------*   *---*   *------------------------*    $ #
#  $    *--------***************---***-----***---**************--------*    $ #
#  $    *--------*             *-----------------*            *--------*    $ #
#  $    *--------*              *****************             *--------*    $ #
#  $    *--------*                                            *--------*    $ #
#  $    *--------**********************************************--------*    $ #
#  $    *------------------------------------------*-------------------*    $ #
#  $    *-----------------*----------------------------------*---------*    $ #
#  $     **************************************************************     $ #
#  $	                                                                    $ #
#  $                                                                        $ #
#  $$$$$$$$$$$$$$$$$$$$$$$$$$$$$$$$$$$$$$$$$$$$$$$$$$$$$$$$$$$$$$$$$$$$$$$$$$ #
#                                                                             #
###############################################################################