###############################################################################
#                                                                             #
#  $$$$$$$$$$$$$$$$$$$$$$$$$$$$$$$$$$$$$$$$$$$$$$$$$$$$$$$$$$$$$$$$$$$$$$$$$$ #
#  $                                                                        $ #
#  $                                                                        $ #
#  $     **************************************************************     $ #
#  $    *------------------------*-----------------*-------------------*    $ #
#  $    *------------*-------------------------------------------------*    $ #
#  $    *--------***********************-**********************--------*    $ #
#  $    *--------*                     *-*                    *--------*    $ #
#  $    *--------*                     *-*                    *--------*    $ #
#  $    *--------*                    *---*                   *--------*    $ #
#  $    *--------*****************   *-----*   ***************---------*    $ #
#  $    *-------------------------* *-------* *------------------------*    $ #
#  $    *--------------------------*---------*-------------------------*    $ #
#  $    *--------------------------------------------------------------*    $ #
#  $    *--------------------------------------------------------------*    $ #
#  $    *--------------------------*---------*-------------------------*    $ #
#  $    *-------------------------* *-------* *------------------------*    $ #
#  $    *--------*****************   *-----*   **************----------*    $ #
#  $    *--------*                    *---*                   *--------*    $ #
#  $    *--------*                     *-*                    *--------*    $ #
#  $    *--------*                     *-*                    *--------*    $ #
#  $    *--------***********************-**********************--------*    $ #
#  $    *------------------------------------------*-------------------*    $ #
#  $    *-----------------*----------------------------------*---------*    $ #
#  $     **************************************************************     $ #
#  $	                                                                    $ #
#  $                                                                        $ #
#  $$$$$$$$$$$$$$$$$$$$$$$$$$$$$$$$$$$$$$$$$$$$$$$$$$$$$$$$$$$$$$$$$$$$$$$$$$ #
#                                                                             #
###############################################################################