###############################################################################
#                                                                             #
#  $$$$$$$$$$$$$$$$$$$$$$$$$$$$$$$$$$$$$$$$$$$$$$$$$$$$$$$$$$$$$$$$$$$$$$$$$$ #
#  $                                                                        $ #
#  $                                                      ************      $ #
#  $    *********                 *********               *----------*      $ #
#  $    *-------*                 *-------*               *----------*      $ #
#  $    *-------*******************-------*****************----------*      $ #
#  $    *------------------------------------------------------------*      $ #
#  $    *-------*******************-------*****************----------*      $ #
#  $    *-------*                 *-------*               *****---****      $ #
#  $    *********                 ***---***                   *---*         $ #
#  $                                *---*                    *---*          $ #
#  $                                *---*                   *---*           $ #
#  $                           ******---******             *---*            $ #
#  $                           *-------------*            *---*             $ #
#  $	                       *-------------*           *---*              $ #
#  $                           *-------------*          *---*               $ #
#  $	                       *-------------*         *---*                $ #
#  $                           *-------------*        *---*                 $ #
#  $                           *-------------*       *---*                  $ #
#  $                           *-------------********---*                   $ #
#  $	                       *-----------------------*                    $ #
#  $                           *-------------**********                     $ #
#  $	                       ***************                              $ #
#  $                                                                        $ #
#  $                                                                        $ #
#  $	                                                                    $ #
#  $                                                                        $ #
#  $$$$$$$$$$$$$$$$$$$$$$$$$$$$$$$$$$$$$$$$$$$$$$$$$$$$$$$$$$$$$$$$$$$$$$$$$$ #
#                                                                             #
###############################################################################