###############################################################################
#                                                                             #
#  $$$$$$$$$$$$$$$$$$$$$$$$$$$$$$$$$$$$$$$$$$$$$$$$$$$$$$$$$$$$$$$$$$$$$$$$$$ #
#  $                                                                        $ #
#  $                                                                        $ #
#  $    *********                 *********                                 $ #
#  $    *-------*                 *-------*                                 $ #
#  $    *-------*******************-------*                                 $ #
#  $    *---------------------------------*                                 $ #
#  $    *-------*******************-------*                                 $ #
#  $    *-------*                 *-------*                                 $ #
#  $    *********                 ****-****                                 $ #
#  $                                 *-*                                    $ #
#  $                                 *-*                                    $ #
#  $                                 *-*                                    $ #
#  $                                 *-*                                    $ #
#  $                               ***-***                                  $ #
#  $                               *-----*                                  $ #
#  $                               *-----*                                  $ #
#  $                               *******                                  $ #
#  $                                                                        $ #
#  $                                                                        $ #
#  $	                                                                    $ #
#  $                                                                        $ #
#  $	                                                                    $ #
#  $                                                                        $ #
#  $                                                                        $ #
#  $	                                                                    $ #
#  $                                                                        $ #
#  $$$$$$$$$$$$$$$$$$$$$$$$$$$$$$$$$$$$$$$$$$$$$$$$$$$$$$$$$$$$$$$$$$$$$$$$$$ #
#                                                                             #
###############################################################################